6 44
00000000000000000000000000000000000000000000
00000000000000000000000000000000000000000000
01111b10101101001001010101111111011101111111
01111110101101001001010101111111011101111111
01111110101101001001010101111111011111111111
0000000000000FACILE0000000TROIS0000000000000
5
2 3
011
110
2 3
110
011
2 3
010
111
2 2
11
11
4 1
1
1
1
1
4 5
17
1
1
1
2
3
4
4
4
4
3
2
2
4
3
4
3
4